x	x	x	x	x	x	x	x	x	x	x	x	x	x	x	x	x	x	x	x	x	x
x	x	x	x	x	x	F	S	S	S	S	G	x	F	S	I	x	F	S	I	x	x
x	x	x	x	x	x	L	x	x	x	x	L	x	L	x	x	x	L	x	x	x	x
x	x	F	S	F	S	K	S	S	S	S	K	S	K	S	S	S	K	S	S	x	x
x	x	L	x	L	x	L	x	x	x	x	L	x	L	x	x	x	L	x	x	x	x
x	x	L	x	L	x	L	x	F	I	x	L	x	E	S	I	x	E	S	I	x	x
x	x	L	x	L	x	L	x	L	x	x	E	I	x	x	x	x	x	x	x	x	x
x	J	K	S	K	S	K	S	K	S	I	x	x	F	S	S	S	S	I	G	x	x
x	x	L	x	L	x	L	x	L	x	x	F	S	H	x	x	x	x	x	L	x	x
x	x	L	x	L	x	L	x	L	x	x	L	x	x	x	x	x	x	x	L	x	x
x	x	L	x	L	x	L	x	L	x	x	L	x	x	x	x	x	x	x	L	x	x
x	x	L	S	N	S	H	x	E	S	S	N	S	S	S	S	S	S	S	H	x	x
x	x	L	x	x	x	x	x	x	x	x	x	x	x	x	x	x	x	x	x	x	x
x	x	L	x	F	S	S	S	I	x	F	S	F	S	S	S	F	S	I	x	x	x
x	x	L	x	L	x	x	x	x	x	L	x	L	x	x	x	L	x	x	x	x	x
x	J	K	S	K	S	S	S	S	S	S	x	E	S	S	S	K	S	S	I	x	x
x	x	L	x	L	x	x	x	x	x	L	x	x	x	x	x	L	x	x	x	x	x
x	x	L	x	E	S	S	S	G	x	E	S	S	G	x	x	E	S	I	x	x	x
x	x	L	x	x	x	x	x	x	x	x	x	x	L	x	x	x	x	x	x	x	x
x	x	L	x	F	S	S	S	S	S	S	G	x	L	x	x	F	S	S	I	x	x
x	J	K	S	H	x	x	x	x	x	x	E	F	N	S	S	H	x	x	x	x	x
x	x	L	x	x	x	x	x	x	x	x	x	L	x	x	x	x	x	x	x	x	x
x	x	L	x	x	x	x	x	x	x	x	x	L	x	x	x	x	x	x	x	x	x
x	x	E	S	S	S	S	S	S	S	S	S	H	x	x	x	x	x	x	x	x	x
x	x	x	x	x	x	x	x	x	x	x	x	x	x	x	x	x	x	x	x	x	x
